"filename", "language", "JavaScript", "CSS", "JSON", "HTML", "comment", "blank", "total"
"d:\Reactjs\amazoneclone\public\index.html", "HTML", 0, 0, 0, -19, -23, -1, -43
"d:\Reactjs\amazoneclone\public\manifest.json", "JSON", 0, 0, -25, 0, 0, -1, -26
"d:\Reactjs\amazoneclone\src\App.css", "CSS", 0, 20, 0, 0, 1, 0, 21
"d:\Reactjs\amazoneclone\src\App.js", "JavaScript", 36, 0, 0, 0, 0, 4, 40
"d:\Reactjs\amazoneclone\src\App.test.js", "JavaScript", 7, 0, 0, 0, 0, 2, 9
"d:\Reactjs\amazoneclone\src\Components\404\Error.js", "JavaScript", 11, 0, 0, 0, 0, 3, 14
"d:\Reactjs\amazoneclone\src\Components\Addtocart\Addtocart.js", "JavaScript", 30, 0, 0, 0, 0, 8, 38
"d:\Reactjs\amazoneclone\src\Components\Footer\Footer.js", "JavaScript", 53, 0, 0, 0, 0, 5, 58
"d:\Reactjs\amazoneclone\src\Components\Footer\Footer.module.css", "CSS", 0, 29, 0, 0, 0, 2, 31
"d:\Reactjs\amazoneclone\src\Components\Header.js", "JavaScript", 75, 0, 0, 0, 0, 7, 82
"d:\Reactjs\amazoneclone\src\Components\Home\Home.js", "JavaScript", 116, 0, 0, 0, 0, 28, 144
"d:\Reactjs\amazoneclone\src\Components\Home\Home.module.css", "CSS", 0, 36, 0, 0, 0, 1, 37
"d:\Reactjs\amazoneclone\src\Components\Login\Login.js", "JavaScript", 30, 0, 0, 0, 0, 6, 36
"d:\Reactjs\amazoneclone\src\Components\Login\Login.module.css", "CSS", 0, 59, 0, 0, 0, 0, 59
"d:\Reactjs\amazoneclone\src\Components\Products\Product.css", "CSS", 0, 0, 0, 0, 0, 1, 1
"d:\Reactjs\amazoneclone\src\Components\Products\Product.js", "JavaScript", 138, 0, 0, 0, 1, 28, 167
"d:\Reactjs\amazoneclone\src\Components\Products\Product.module.css", "CSS", 0, 124, 0, 0, 0, 2, 126
"d:\Reactjs\amazoneclone\src\Components\Shop\Fashion\Fashion.module.css", "CSS", 0, 48, 0, 0, 0, 1, 49
"d:\Reactjs\amazoneclone\src\Components\Shop\Fashion\FashionHome.js", "JavaScript", 39, 0, 0, 0, 0, 14, 53
"d:\Reactjs\amazoneclone\src\Components\Shop\Fashion\Fashionproducts.js", "JavaScript", 87, 0, 0, 0, 0, 7, 94
"d:\Reactjs\amazoneclone\src\Components\Shop\Fitness\Fitness.js", "JavaScript", 38, 0, 0, 0, 0, 8, 46
"d:\Reactjs\amazoneclone\src\Components\Shop\Fitness\Fitness.module.css", "CSS", 0, 19, 0, 0, 0, 0, 19
"d:\Reactjs\amazoneclone\src\Components\Shop\PersonalCare\Perosnalhome.js", "JavaScript", 16, 0, 0, 0, 0, 3, 19
"d:\Reactjs\amazoneclone\src\Components\Shop\PersonalCare\Personal.js", "JavaScript", 19, 0, 0, 0, 0, 3, 22
"d:\Reactjs\amazoneclone\src\Components\Shop\PersonalCare\Personal.module.css", "CSS", 0, 10, 0, 0, 0, 2, 12
"d:\Reactjs\amazoneclone\src\Components\Shop\PersonalCare\Personalcareproducts.js", "JavaScript", 33, 0, 0, 0, 0, 0, 33
"d:\Reactjs\amazoneclone\src\Components\Shop\Shop.js", "JavaScript", 43, 0, 0, 0, 0, 9, 52
"d:\Reactjs\amazoneclone\src\Components\Shop\Shop.module.css", "CSS", 0, 26, 0, 0, 0, 0, 26
"d:\Reactjs\amazoneclone\src\Components\Shop\Shophome.js", "JavaScript", 17, 0, 0, 0, 0, 4, 21
"d:\Reactjs\amazoneclone\src\Components\Signup\Signup.js", "JavaScript", 77, 0, 0, 0, 0, 14, 91
"d:\Reactjs\amazoneclone\src\Components\Signup\Signup.module.css", "CSS", 0, 98, 0, 0, 0, 1, 99
"d:\Reactjs\amazoneclone\src\Components\carousel\Carousel.module.css", "CSS", 0, 9, 0, 0, 0, 0, 9
"d:\Reactjs\amazoneclone\src\Components\carousel\Carouselitem.js", "JavaScript", 91, 0, 0, 0, 0, 26, 117
"d:\Reactjs\amazoneclone\src\Components\carousel\Gifts.js", "JavaScript", 58, 0, 0, 0, 0, 17, 75
"d:\Reactjs\amazoneclone\src\css\Header.module.css", "CSS", 0, 93, 0, 0, 16, 3, 112
"d:\Reactjs\amazoneclone\src\index.css", "CSS", 0, 15, 0, 0, 0, 2, 17
"d:\Reactjs\amazoneclone\src\index.js", "JavaScript", 10, 0, 0, 0, 3, 4, 17
"d:\Reactjs\amazoneclone\src\redux\Action.js", "JavaScript", 6, 0, 0, 0, 0, 0, 6
"d:\Reactjs\amazoneclone\src\redux\Main.js", "JavaScript", 6, 0, 0, 0, 0, 3, 9
"d:\Reactjs\amazoneclone\src\redux\Reducer.js", "JavaScript", 14, 0, 0, 0, 0, 1, 15
"d:\Reactjs\amazoneclone\src\redux\Store.js", "JavaScript", 6, 0, 0, 0, 0, 2, 8
"Total", "-", 1056, 586, -25, -19, -2, 219, 1815